0,0,0,0,0,0,22,22,22,22,22,0,0,0,0,0,0
0,0,0,0,22,24,24,2,2,2,24,24,22,0,0,0,0
0,0,0,22,24,2,26,26,26,26,26,2,24,22,0,0,0
0,0,22,24,26,39,39,39,39,39,39,26,2,24,22,0,0
0,22,24,26,39,55,55,55,55,55,55,55,39,26,24,22,0
22,24,26,39,55,59,59,59,59,59,59,59,55,39,26,24,22
22,24,26,39,55,59,0,0,0,0,0,59,55,39,26,24,22
22,24,17,17,55,59,0,0,17,17,17,59,55,39,26,24,22
0,56,17,17,17,0,0,56,17,17,17,17,0,0,0,0,0
0,56,56,56,17,17,0,56,56,56,17,17,17,0,17,17,0
--