0,0,0,0,0,0,0,0,0,0,0,0,0,0,0,0,0,0,0
4,4,0,0,4,0,0,0,0,0,0,0,0,0,4,0,0,4,1
4,4,0,0,4,5,0,0,0,0,0,0,0,5,4,0,0,4,4
4,4,5,0,4,1,0,0,0,0,0,0,0,4,4,0,5,4,4
4,4,4,0,4,4,0,0,0,0,0,0,0,4,4,0,4,4,4
4,4,4,0,4,4,0,0,0,5,0,0,0,4,4,0,4,4,4
2,4,4,0,4,4,0,0,5,4,5,0,0,1,4,0,4,4,2
2,4,4,0,4,4,0,0,4,4,4,0,0,4,4,0,4,4,2
2,4,4,4,4,4,0,0,4,4,4,0,0,4,4,4,4,4,2
3,4,4,4,4,4,4,4,4,4,4,4,4,4,4,4,1,4,3
3,4,4,4,4,4,4,4,4,4,4,4,4,4,4,4,4,4,3
3,2,2,2,1,1,5,1,1,1,1,1,5,1,1,2,2,2,3
--