0,0,0,0,0,7,7,7,7,0,0,0,0,0,0,0,0,0,0,0,0,0,0,0,0,0,0,0,0,0,0,0,0
0,0,0,0,7,0,0,0,0,7,0,0,0,0,0,0,0,4,4,4,4,4,4,4,4,4,4,4,4,4,4,4,0
0,0,0,7,7,7,0,0,7,7,7,0,0,0,0,0,4,4,4,4,4,4,4,4,4,4,4,4,4,4,4,4,0
0,0,7,7,0,0,0,0,0,7,0,7,0,0,0,0,4,4,4,4,4,3,3,3,4,4,4,4,4,4,4,4,0
0,0,0,7,7,7,0,0,0,7,7,7,0,0,0,0,4,4,4,4,4,4,4,4,4,4,4,4,4,4,4,4,0
0,0,7,2,2,2,7,0,7,2,2,2,7,0,0,0,4,4,4,4,4,4,4,4,4,4,4,4,4,4,4,4,0
0,0,0,7,7,7,0,0,0,7,7,7,7,0,0,0,4,4,4,4,4,4,4,4,4,4,4,4,4,4,4,4,0
0,0,0,7,0,7,0,0,0,7,0,7,0,0,0,0,4,4,4,4,4,4,4,4,4,4,4,4,4,4,4,4,0
0,0,0,7,0,0,0,0,0,7,0,0,0,7,0,0,4,4,4,4,4,4,4,4,4,4,4,4,4,4,4,4,0
0,0,0,7,0,7,0,0,0,7,0,0,7,0,0,4,4,4,4,4,4,4,4,4,4,4,4,3,3,4,4,4,0
0,0,0,7,0,7,0,0,0,7,0,7,0,0,0,4,4,4,4,4,4,4,4,4,4,4,4,4,4,4,4,0,0
0,0,0,7,0,7,0,0,0,7,0,7,0,0,0,4,4,4,4,4,4,4,4,4,4,4,4,4,4,4,4,0,0
0,0,0,7,0,7,0,0,0,7,0,7,0,0,0,4,4,4,4,4,4,4,4,4,4,4,4,4,4,4,4,0,0
0,0,0,7,0,0,7,7,7,0,0,7,0,0,0,4,4,4,4,4,4,4,4,4,4,4,4,4,4,4,4,0,0
0,0,0,7,0,0,0,0,0,0,7,0,0,0,0,4,4,4,4,4,4,4,4,4,4,4,4,4,4,4,4,0,0
0,0,0,0,7,0,0,0,0,7,0,0,0,0,0,4,4,4,4,4,4,4,4,4,4,4,4,4,4,4,4,0,0
0,0,0,0,0,7,7,7,7,0,0,0,0,0,0,0,0,0,0,0,0,0,0,0,0,0,0,0,0,0,0,0,0
--