0,0,0,0,0,0,4,4,4,4,0,0,0,0,0,0,0,0,0,0,0,0,0,0,0,0,0,0,0,0,0,0,0
0,0,0,0,4,4,4,4,4,4,4,4,0,0,0,0,0,0,0,0,0,0,4,4,4,4,2,0,0,0,0,0,0
0,0,0,4,4,4,4,4,4,4,4,4,4,0,0,0,0,0,0,0,4,4,4,4,4,4,4,4,2,0,0,0,0
0,0,4,4,4,4,2,2,4,4,4,2,2,4,0,0,0,0,0,4,4,4,4,4,4,4,4,4,4,2,0,0,0
0,0,4,4,4,2,2,2,2,4,2,2,2,2,0,0,0,0,4,4,4,4,4,4,4,4,4,4,4,4,2,0,0
0,0,4,4,4,2,2,3,3,4,2,2,3,3,0,0,0,0,4,4,4,4,4,4,4,4,4,4,4,4,2,0,0
0,4,4,4,4,2,2,3,3,4,2,2,3,3,2,0,0,2,4,4,4,4,4,4,4,4,4,4,4,4,4,2,0
0,1,4,4,4,4,2,2,4,4,4,2,2,4,2,0,0,2,4,4,4,4,4,4,4,2,0,0,0,0,0,0,0
0,4,4,4,4,4,4,4,4,4,4,4,4,4,2,0,0,2,4,4,4,4,4,2,0,0,0,0,0,0,0,0,0
0,2,4,4,4,4,4,4,4,4,4,4,4,4,2,0,0,2,4,4,4,4,4,4,4,4,0,0,0,0,0,0,0
0,2,4,4,4,4,4,4,4,4,4,4,4,4,2,0,0,2,4,4,4,4,4,4,4,4,2,2,2,2,2,2,0
0,2,4,4,4,4,4,4,4,4,4,4,4,4,2,0,0,0,2,4,4,4,4,4,4,4,4,4,4,4,4,0,0
0,2,4,4,4,4,4,4,4,4,4,4,4,4,2,0,0,0,2,4,4,4,4,4,4,4,4,4,4,4,4,0,0
0,2,4,4,4,4,4,4,4,4,4,4,4,4,2,0,0,0,0,2,4,4,4,4,4,4,4,4,4,4,0,0,0
0,2,4,4,4,4,4,4,4,4,4,4,4,4,2,0,0,0,0,0,2,2,4,4,4,4,4,4,4,0,0,0,0
0,2,4,4,4,0,4,4,4,4,0,4,4,4,2,0,0,0,0,0,0,0,2,2,2,2,2,0,0,0,0,0,0
0,0,1,1,0,0,0,1,1,0,0,0,1,1,0,0,0,0,0,0,0,0,0,0,0,0,0,0,0,0,0,0,0
--