0,0,0,0,0,0,0,1,1,1,0,0,0,0,0,0,0
0,0,0,0,0,1,1,2,2,2,1,1,0,0,0,0,0
0,0,0,1,1,2,2,3,3,3,2,2,1,1,0,0,0
0,0,1,2,2,3,3,4,4,4,3,3,2,2,1,0,0
0,1,2,3,3,4,4,5,5,5,4,4,3,3,2,1,0
1,2,3,4,5,5,5,7,7,7,5,5,5,4,3,2,1
1,2,3,4,5,7,7,0,0,0,7,7,5,4,3,2,1
1,2,3,4,5,7,0,0,0,0,0,7,5,4,3,2,1
0,0,0,0,0,0,0,0,0,0,0,0,0,0,0,0,0
0,7,7,0,5,5,0,4,4,4,0,5,5,0,7,7,0
--