0,0,0,0,0,0,0,0,0,0,0,0,0,0,0,9,9,9,9,9,9,9,9,9,0,0,0,0,0,0,0,0,0
0,0,0,9,9,9,9,9,9,9,9,9,0,0,4,9,4,4,4,4,4,4,4,9,9,9,9,9,9,9,9,9,0
0,0,4,9,4,4,4,4,4,4,4,9,0,0,4,9,0,0,0,0,4,9,4,9,4,4,4,4,4,4,1,9,0
0,0,4,9,0,0,0,0,0,0,4,9,0,0,4,9,0,0,0,0,4,9,4,9,0,0,0,0,0,0,4,9,0
0,9,9,9,9,9,9,9,9,9,4,9,9,9,9,9,9,9,9,9,9,9,4,9,9,9,9,9,0,0,4,9,0
1,9,4,4,4,4,4,4,4,4,4,9,4,4,4,4,4,4,4,4,4,4,4,9,4,4,4,9,0,0,4,9,0
4,9,4,9,0,0,0,0,0,0,4,9,0,0,4,9,0,0,0,0,4,9,4,9,0,0,4,9,0,0,4,9,0
4,9,4,9,0,0,0,9,9,9,9,9,9,9,4,9,9,9,9,9,4,9,4,9,9,9,9,9,9,9,9,9,0
4,9,4,9,0,0,1,9,4,4,4,4,4,4,4,9,4,4,4,9,4,4,4,9,4,4,4,9,4,4,1,0,0
4,9,4,9,0,0,4,9,0,0,4,9,0,0,4,9,0,0,4,9,0,0,4,9,0,0,4,9,0,0,0,0,0
4,9,4,9,0,0,4,9,0,0,4,9,0,0,4,9,9,9,4,9,9,9,9,9,0,0,4,9,0,0,0,0,0
4,9,4,9,9,9,9,9,9,9,9,9,0,0,4,4,4,4,4,9,4,4,4,0,0,0,4,9,0,0,0,0,0
4,9,4,4,4,4,4,4,4,4,4,0,0,0,0,0,0,0,4,9,0,0,0,0,0,0,4,9,0,0,0,0,0
4,9,0,0,0,0,4,9,0,0,0,0,0,0,0,0,0,0,4,9,0,0,0,0,0,0,4,9,0,0,0,0,0
4,9,9,9,9,9,4,9,9,9,9,9,9,9,9,9,9,9,4,9,9,9,9,9,9,9,9,9,0,0,0,0,0
4,4,4,1,4,4,4,9,9,9,9,9,9,9,9,9,9,9,9,9,4,4,4,4,4,4,4,0,0,0,0,0,0
0,0,0,0,0,0,4,1,4,4,4,4,4,4,4,4,4,1,4,0,0,0,0,0,0,0,0,0,0,0,0,0,0
--