1,2,3,4,5,6,7,1,1,2,3,4,5,6,7,1,2
7,1,2,3,4,5,6,7,1,1,2,3,4,5,6,7,1
6,7,1,2,3,4,5,6,7,1,1,2,3,4,5,6,7
5,6,7,1,2,3,4,5,6,7,1,1,2,3,4,5,6
4,5,6,7,1,2,3,4,5,6,7,1,1,2,3,4,5
3,4,5,6,7,1,2,3,4,5,6,7,1,1,2,3,4
2,3,4,5,6,7,1,2,3,4,5,6,7,1,1,2,3
1,2,3,4,5,6,7,1,1,2,3,4,5,6,7,1,2
--