0,9,0,5,0,5,0,0,0,0,0,0,0,0,0,0,0,0,0,0,0,0,0,0,0,0,0,5,0,5,0,9,0
9,0,5,0,5,0,0,0,0,0,0,0,0,9,9,9,9,9,9,9,0,0,0,0,0,0,0,0,5,0,5,0,9
0,5,0,5,0,0,0,0,0,0,0,9,9,0,0,0,0,0,0,0,9,9,0,0,0,0,0,0,0,5,0,5,0
5,0,5,0,0,0,0,0,0,9,9,0,0,0,7,7,7,7,7,0,0,0,9,9,0,0,0,0,0,0,5,0,5
0,5,0,0,0,0,0,9,9,0,0,0,7,7,0,0,0,0,0,7,7,0,0,0,9,9,0,0,0,0,0,5,0
5,0,0,0,0,9,9,0,0,0,7,7,0,0,0,9,9,9,0,0,0,7,7,0,0,0,9,9,0,0,0,0,5
0,0,0,9,9,0,0,0,7,7,0,0,0,9,9,0,0,0,9,9,0,0,0,7,7,0,0,0,9,9,0,0,0
0,9,9,0,0,0,7,7,0,0,0,0,9,0,0,0,2,0,0,0,9,0,0,0,0,7,7,0,0,0,9,9,0
9,0,0,0,7,7,0,0,0,9,9,9,0,0,2,2,3,2,2,0,0,9,9,9,0,0,0,7,7,0,0,0,9
0,9,9,0,0,0,7,7,0,0,0,0,9,0,0,0,2,0,0,0,9,0,0,0,0,7,7,0,0,0,9,9,0
0,0,0,9,9,0,0,0,7,7,0,0,0,9,9,0,0,0,9,9,0,0,0,7,7,0,0,0,9,9,0,0,0
5,0,0,0,0,9,9,0,0,0,7,7,0,0,0,9,9,9,0,0,0,7,7,0,0,0,9,9,0,0,0,0,5
0,5,0,0,0,0,0,9,9,0,0,0,7,7,0,0,0,0,0,7,7,0,0,0,9,9,0,0,0,0,0,5,0
5,0,5,0,0,0,0,0,0,9,9,0,0,0,7,7,7,7,7,0,0,0,9,9,0,0,0,0,0,0,5,0,5
0,5,0,5,0,0,0,0,0,0,0,9,9,0,0,0,0,0,0,0,9,9,0,0,0,0,0,0,0,5,0,5,0
9,0,5,0,5,0,0,0,0,0,0,0,0,9,9,9,9,9,9,9,0,0,0,0,0,0,0,0,5,0,5,0,9
0,9,0,5,0,5,0,0,0,0,0,0,0,0,0,0,0,0,0,0,0,0,0,0,0,0,0,5,0,5,0,9,0
--