0,0,0,0,0,0,0,0,0,0,0,0,0,0,0,0,0,0,4,4,4,0,0,0,0,0,4,4,4,0,0,0,0
0,0,0,0,0,0,4,4,4,4,4,0,0,0,0,0,0,0,4,4,4,4,0,0,0,4,4,4,4,0,0,0,0
0,0,0,0,4,4,4,4,4,4,4,4,4,0,0,0,0,0,4,4,2,4,4,4,4,4,2,4,4,0,0,0,0
0,0,0,4,4,4,4,4,4,4,2,2,4,4,0,0,0,0,4,4,4,4,4,4,4,2,2,4,4,0,0,0,0
0,0,4,4,4,4,4,4,4,2,3,3,2,4,4,0,0,0,0,4,4,4,4,4,4,4,4,4,0,0,0,0,0
0,0,4,4,4,4,4,4,4,2,3,3,2,4,4,0,0,0,0,4,3,4,4,4,4,4,4,4,0,4,4,0,0
0,4,4,4,4,4,4,4,4,4,2,2,4,4,4,4,0,0,0,4,2,2,4,4,4,4,4,4,0,4,4,4,0
0,4,4,4,4,4,4,4,4,4,4,4,4,4,4,4,0,0,4,4,3,3,2,4,4,4,4,4,0,4,4,4,0
0,4,4,4,4,4,4,4,4,4,4,4,4,4,4,4,0,0,4,4,4,4,4,4,4,4,4,4,4,4,4,0,0
0,4,4,4,4,4,4,4,4,4,4,4,4,4,4,4,0,0,4,4,4,4,4,4,4,4,4,4,4,4,0,0,0
0,0,4,4,4,4,4,4,4,4,4,4,4,4,4,0,0,0,0,4,4,4,4,4,4,4,4,4,4,4,4,0,0
0,0,4,4,4,4,4,4,4,4,4,4,4,4,4,4,4,0,0,0,0,4,4,4,4,4,4,4,4,4,4,0,0
0,0,0,4,4,4,4,4,4,4,4,4,4,4,4,4,4,4,4,4,4,4,4,4,4,4,4,4,4,4,4,0,0
0,0,0,4,4,4,4,4,4,4,4,4,4,2,2,2,4,4,4,4,4,4,4,4,4,4,4,4,4,4,4,0,0
0,0,0,4,4,4,4,4,4,4,4,4,4,4,4,4,4,4,4,4,4,4,4,4,4,4,4,2,2,2,0,0,0
0,0,0,0,4,4,4,4,4,4,4,4,4,4,4,4,4,4,4,4,4,4,4,4,4,4,4,0,0,0,0,0,0
0,0,0,0,0,0,0,0,0,0,0,0,0,0,0,0,0,0,0,0,0,0,0,0,0,0,0,0,0,0,0,0,0
--