0,0,0,0,0,0,0,0,0,0,0,0,0,0,9,9,9,9,9,0,0,0,0,0,0,0,0,0,0,0,0,0,0
0,0,0,0,0,0,0,0,0,0,0,0,9,9,9,9,9,9,9,9,9,0,0,0,0,0,0,0,0,0,0,0,0
3,3,3,3,3,3,3,3,3,3,3,9,9,9,9,9,9,9,2,2,9,9,3,3,3,3,3,3,3,3,3,3,3
0,0,0,0,0,0,0,0,0,0,9,9,9,9,9,9,9,9,2,2,2,9,9,0,0,0,0,0,0,0,0,0,0
2,2,2,2,2,2,2,2,2,9,9,9,9,9,9,9,9,9,9,2,2,9,9,9,2,2,2,2,2,2,2,2,2
0,0,0,0,0,0,0,0,0,9,9,9,9,9,9,9,9,9,9,9,9,9,9,9,0,0,0,0,0,0,0,0,0
7,7,7,7,7,7,7,7,9,9,9,9,9,9,9,9,9,9,9,9,9,9,9,9,9,7,7,7,7,7,7,7,7
0,0,0,0,0,0,0,0,9,9,9,9,9,9,9,9,9,9,9,9,9,9,9,9,9,0,0,0,0,0,0,0,0
2,2,2,2,2,2,2,2,9,9,9,9,9,9,9,9,9,9,9,9,9,9,9,9,9,2,2,2,2,2,2,2,2
0,0,0,0,0,0,0,0,9,9,9,9,9,9,9,9,9,9,9,9,9,9,9,9,9,0,0,0,0,0,0,0,0
7,7,7,7,7,7,7,7,9,9,9,9,9,9,9,9,9,9,9,9,9,9,9,9,9,7,7,7,7,7,7,7,7
0,0,0,0,0,0,0,0,0,9,9,9,9,9,9,9,9,9,9,9,9,9,9,9,0,0,0,0,0,0,0,0,0
2,2,2,2,2,2,2,2,2,9,9,9,2,2,9,9,9,9,9,9,9,9,9,9,2,2,2,2,2,2,2,2,2
0,0,0,0,0,0,0,0,0,0,9,9,2,2,2,9,9,9,9,9,9,9,9,0,0,0,0,0,0,0,0,0,0
4,4,4,4,4,4,4,4,4,4,4,9,9,2,2,9,9,9,9,9,9,9,4,4,4,4,4,4,4,4,4,4,4
0,0,0,0,0,0,0,0,0,0,0,0,9,9,9,9,9,9,9,9,9,0,0,0,0,0,0,0,0,0,0,0,0
0,0,0,0,0,0,0,0,0,0,0,0,0,0,9,9,9,9,9,0,0,0,0,0,0,0,0,0,0,0,0,0,0
--