0,0,0,0,0,0,3,2,1,2,3,0,0,0,0,0,0
0,0,0,0,2,4,4,4,4,4,4,4,2,0,0,0,0
0,0,0,2,4,4,4,4,4,4,4,4,4,2,0,0,0
0,0,2,4,4,4,4,4,4,4,4,4,4,4,2,0,0
0,2,4,4,4,4,4,4,4,4,4,4,4,4,4,2,0
3,4,4,4,4,4,4,4,4,4,4,4,4,4,4,4,3
3,4,4,4,4,4,0,0,0,0,0,4,4,4,4,4,3
3,4,4,4,4,4,0,0,4,4,4,4,4,4,4,4,3
0,2,4,4,1,0,0,2,4,4,4,1,0,0,0,0,0
0,3,2,2,4,4,0,3,2,2,4,4,4,0,2,3,0
--